005,020,020,020,020,020,024,020,020,020,020,020,006,014
015,000,000,000,000,100,022,000,000,000,000,000,013,014
023,002,003,000,000,400,000,000,000,000,007,008,012,014
015,000,000,000,000,000,000,000,000,000,019,020,020,006
015,200,100,007,008,008,009,000,300,100,000,000,100,013
011,008,008,012,005,020,021,000,000,000,004,000,001,017
014,014,014,014,015,000,000,000,000,000,000,000,000,013
014,014,014,014,015,000,000,000,500,007,009,000,000,013
014,014,014,014,011,008,008,008,008,012,011,008,008,012
